Ў	губно-губной;срединный аппрокcимант;звонкий;твёрдый
б	губно-губной;взрывной;звонкий;твёрдый
б’	губно-губной;взрывной;звонкий;мягкий
п	губно-губной;взрывной;глухой;твёрдый
п’	губно-губной;взрывной;глухой;мягкий
м	губно-губной;носовой;звонкий;твёрдый
м’	губно-губной;носовой;звонкий;мягкий
м ̯	губно-губной;носовой;глухой;твёрдый
м ̯’	губно-губной;носовой;глухой;мягкий
в	губно-зубной;щелевой;звонкий;твёрдый
ф	губно-зубной;щелевой;глухой;твёрдый
ф’	губно-зубной;щелевой;глухой;мягкий
в’	губно-зубной;щелевой;звонкий;мягкий
ɱ	губно-зубной;носовой;звонкий;твёрдый
ɱ’	губно-зубной;носовой;звонкий;мягкий
л	переднеязычный зубной;боковой аппроксимант;звонкий;твёрдый
л ̯	переднеязычный зубной;боковой аппроксимант;глухой;твёрдый
з	переднеязычный зубной;щелевой;звонкий;твёрдый
з’	переднеязычный зубной;щелевой;звонкий;мягкий
с	переднеязычный зубной;щелевой;глухой;твёрдый
с’	переднеязычный зубной;щелевой;глухой;мягкий
д	переднеязычный зубной;взрывной;звонкий;твёрдый
д’	переднеязычный зубной;взрывной;звонкий;мягкий
т	переднеязычный зубной;взрывной;глухой;твёрдый
т’	переднеязычный зубной;взрывной;глухой;мягкий
дз	переднеязычный зубной;аффриката;звонкий;твёрдый
дз’	переднеязычный зубной;аффриката;звонкий;мягкий
ц	переднеязычный зубной;аффриката;глухой;твёрдый
ц’	переднеязычный зубной;аффриката;глухой;мягкий
н	переднеязычный зубной;носовой;звонкий;твёрдый
н’	переднеязычный зубной;носовой;звонкий;мягкий
н ̯	переднеязычный зубной;носовой;глухой;твёрдый
н ̯’	переднеязычный зубной;носовой;глухой;мягкий
л’	переднеязычный передненёбный;боковой аппроксимант;звонкий;мягкий
л ̯’	переднеязычный передненёбный;боковой аппроксимант;глухой;мягкий
ж	переднеязычный передненёбный;щелевой;звонкий;твёрдый
ж’	переднеязычный передненёбный;щелевой;звонкий;мягкий
ш	переднеязычный передненёбный;щелевой;глухой;твёрдый
ш’	переднеязычный передненёбный;щелевой;глухой;мягкий
дж	переднеязычный передненёбный;аффриката;звонкий;твёрдый
дж’	переднеязычный передненёбный;аффриката;звонкий;мягкий
ч	переднеязычный передненёбный;аффриката;глухой;твёрдый
ч’	переднеязычный передненёбный;аффриката;глухой;мягкий
р	переднеязычный передненёбный;дрожащий;звонкий;твёрдый
р’	переднеязычный передненёбный;дрожащий;звонкий;мягкий
р ̯	переднеязычный передненёбный;дрожащий;глухой;твёрдый
р ̯’	переднеязычный передненёбный;дрожащий;глухой;мягкий
и̭	среднеязычный средненёбный;срединный аппроксимант;звонкий;мягкий
j	среднеязычный средненёбный;щелевой;звонкий;мягкий
j ̯	среднеязычный средненёбный;щелевой;глухой;мягкий
ϒ’	заднеязычный средненёбный;щелевой;звонкий;мягкий
х’	заднеязычный средненёбный;щелевой;глухой;мягкий
г’	заднеязычный средненёбный;взрывной;звонкий;мягкий
к’	заднеязычный средненёбный;взрывной;глухой;мягкий
ϒ	заднеязычный задненёбный;щелевой;звонкий;твёрдый
х	заднеязычный задненёбный;щелевой;глухой;твёрдый
г	заднеязычный задненёбный;взрывной;звонкий;твёрдый
к	заднеязычный задненёбный;взрывной;глухой;твёрдый
ŋ	заднеязычный задненёбный;носовой;звонкий;твёрдый
ŋ’	заднеязычный задненёбный;носовой;звонкий;мягкий
?	гортанный;взрывной;глухой;твёрдый